###########################################
#@                                        #
#                          .              #
#                                         #
#                                         #
#                                         #
#                                         #
#                              $          #
#                                         #
#                                         #
#                                         #
###########################################


