##############################################################
#@                                                           #
#                                              .             #
#                                                            #
#                                                            #
#                                                            #
#                                                            #
#                              $                             #
#                                                            #
#                                                            #
#                                                            #
##############################################################


