#################
#@              #
#           $   #
#      .        #
#               #
#               #
#               #
#################


