########
#. $   #
#. $   #
#.  $ @#
#. $   #
#. $   #
#####  #
    #  #
    #  #
    ####