##########################################
#@                                     ..#
#                                      ..#
#                                        #
#                                        #
#              $            $            #
#                                        #
#                                        #
#                                        #
#                                        #
#                    $            $      #
################# ###### #################
               #          #
               ############