######
#@ $.#
#  $.#
#  $.#
#  $.#
######