#######
###.###
# . ###
#.$*$.#
#..  .#
#*#$$$#
#  @$.#
##$$  #
#     #
#######