#########
#@      #
#       #
# $$$...#
#    ####
#    #
######