##############################
#   #### $   .   .######  .  #
# @ #### ####     ######  .  #
#   #### ####  $  ######  $  #
## ##### ####     ######     #
## ##### ####     ######     #
## ####   #####$##########$###
##    $ .      .           ###
#######   #              # ###
#######   ################$###
##                          ##
#   # $ #   #    #   # $ #.  #
#  #  .  #   #  #   #  .  #  #
#   #   #   #    #   #   #   #
##                          ##
##############################